WPPPPFFFFFFFFFWWWFFFFFFFFF
WPPP#PFFFFFFFFFWWWFFFFFFFFF
WPPPPFFFFFFFFFWWWFFFFFFFFF
WMMRRRRRPPPPPPPPPPPSMPPPPP
WMMBBBBBPPPPPPPPPPPSMPPPPP
WMMBBBBBPPPPPPPPPPPSMPPPPP
WMMRRRRRPPPPPPPPPPPSMPPPPP
WMMRRRRRPPPPPPPPPPSMPPPPPP
WMMRRRRRPPPPPPPPPPSMPPPPPP
WMMMMMRRPPPPPPPPPPSMPPPPPP
WMMMMMRRPPPPPPPPPPPPPPPPPP
WMMMMMRRRRRBBRRRRPPPPPPPPP
WMMMMMRRRRRBBRRRRPPPPPPPPP
WMMMMMRRFFFFFFFFFFFFF#SMPPP
WMMMMMRRFFFFFFFFFFFFFSMPPP
WMMMMMRRFFFFFFFFFFFFFPPPPP
WWWWWWWWWWWWWWWWPPPPPPPPPP