RPPPPFFFFFFFFFRRRFFFFFFFFF
RPPP#PFFFFFFFFFRRRFFFFFFFFF
RPPPPFFFFFFFFFRRRFFFFFFFFF
RMMWWWWWPPPPPPPPPPPSMPPPPP
RMMBBBBBPPPPPPPPPPPSMPPPPP
RMMBBBBBPPPPPPPPPPPSMPPPPP
RMMWWWWWPPPPPPPPPPPSMPPPPP
RMMWWWWWPPPPPPPPPPSMPPPPPP
RMMWWWWWPPPPPPPPPPSMPPPPPP
RMMMMMWWPPPPPPPPPPSMPPPPPP
RMMMMMWWPPPPPPPPPPPPPPPPPP
RMMMMMWWWWWBBWWWWPPPPPPPPP
RMMMMMWWWWWBBWWWWPPPPPPPPP
RMMMMMWWFFFFFFFFFFFFF#SMPPP
RMMMMMWWFFFFFFFFFFFFFSMPPP
RMMMMMWWFFFFFFFFFFFFFPPPPP
RRRRRRRRRRRRRRRRPPPPPPPPPP