TTMM#MMMMMTTTTMMMMMMMMMMTTT
TTTTMMMMTTTTTLLMMMMMMLLLTT
TTTLLMMTTTTTTTLLTTTTTTTMTT
TBTLTTTTTMMTTLTLBTLLTTBBBT
LBLLTTTTMMTTLTTLBLTTLLTLLL
TBTTTTLMMLTLLTTTBTTTTLLLTT
TTTTTTMMLLLLTTTTTTTMTTLTTT
LLLTTTTLTTTTTTTTTLLMMTLLTT
LTLLTTBBBTTTLLLTTTLTMMTLTT
MTTLLLLLTTTTTLTTTTTTMTLLTT
MMTTTTTTTTTTTLLTLTTLLMTTTT
LMMTTTTTTTTTTTLLTTTLTMMTTT
LLMMMLLTTTLTTTTTTTTLTTMTLL
TTLMMLLLTTLTTTTTTBBLTTMTLT
TTLLLLTLTTMLTMLLTLBBTTTTLT
TTTTLLTTTMMTTMMLLLTTTTTTLT
TTTTTTTTMMTTTTMMMMMM#TTTTTT