PPPPPPPPPPPPPPPPPRRRFFFFFF
PPPPPPPPPPPPP#PPPPRRRFFFFFF
PPPPPPPPPPPPPPPPPRRRFFFFFF
PPPPPPPPPPPPPPPPPRRRFFFFFF
WWWWWWWBWWWWWWFFFFFFFFFFFF
WWWWWWWBWWWWWWFFFFFFFFFFFF
MMMMMMMMMMMMMMFFFFFFFFFFFF
MMWWWMMMMMMMMMFFFFFFFFFFFF
MMBBBMMMMMMMMMFFFFFFFFFFFF
MMWWWMMMMMMMMMMMMMMMMMMMMM
PPPPPPPPPPPPPPPPPPSSSSSSSS
PPPPPPPPPPPPRRRRRRSSSSSSSS
PPPPPPPPRRRRRRRRRRRRRRRRRR
PPPPPPPPRRRRRRRRRRRRRRRRRR
PPPPPPPPRRRRRRRRRRRRFFFFFF
FFFFFFF#FFFFFFFFFFFFFFFFFFF
FFFFFFFFFFFFFFFFFFFFFFFFFF