PPPPPPPPPPPPPPPPPWWWFFFFFF
PPPPPPPPPPPPP#PPPPWWWFFFFFF
PPPPPPPPPPPPPPPPPWWWFFFFFF
PPPPPPPPPPPPPPPPPWWWFFFFFF
RRRRRRRBRRRRRRFFFFFFFFFFFF
RRRRRRRBRRRRRRFFFFFFFFFFFF
MMMMMMMMMMMMMMFFFFFFFFFFFF
MMRRRMMMMMMMMMFFFFFFFFFFFF
MMBBBMMMMMMMMMFFFFFFFFFFFF
MMRRRMMMMMMMMMMMMMMMMMMMMM
PPPPPPPPPPPPPPPPPPSSSSSSSS
PPPPPPPPPPPPWWWWWWSSSSSSSS
PPPPPPPPWWWWWWWWWWWWWWWWWW
PPPPPPPPWWWWWWWWWWWWWWWWWW
PPPPPPPPWWWWWWWWWWWWFFFFFF
FFFFFFF#FFFFFFFFFFFFFFFFFFF
FFFFFFFFFFFFFFFFFFFFFFFFFF