PPPPPPMPPPPPPPPPPPPFFFFFFF
PPWWMMMPPSSSSSSSMSPFFFFWWF
PWWMMWPSSMSMMMMSSMSPPFFFWF
PPMMWPPPSMMSSMMSMMMPPFFFWF
SPPPPPPPPPPSSSPPPPPPPPPFFF
SSPPPPPPPPPPSPPPRRRWPPPFFF
PPPPSSPPPPPPPPPRRWWSWPPFFF
PP#PSSPPPPBPPPPPRRSSSWWPPPP
PPSSPPPPRBRPPPBBBBPPSPPPSM
SSSPPPPRRBRRPPPRRPPPPPSSMM
PPPPPPRRPBPRPPRRPPPPPSSMMP
PPPSSRRPPPPRSSRPPPPPMMSSP#P
PPPSRRRPPPPRRRRPPPPPPMSSPP
PPWSRRPPPPPPPPPPPPPPPMMMSP
PWWWPPPPFFFFRPPPPFFPPPPMPP
PWWWFFFFFRRRRPPFFFFFFPPMMP
WWFFFFFFFRFFFFPFFFFFFFPPMP